{
  "left": "top",
  "right": [
    "open",
    "split",
    "shelf"
  ],
  "layers": [
    [
      "11111111111111111111",
      "0",
      "0",
      "0",
      "0",
      "0",
      "0",
      "0",
      "0",
      "0",
      "11110000000000000000",
      "11111000000000000000",
      "11111100000000000000",
      "11111110000000000000",
      "11111111000000000000",
      "11111111100000000000",
      "11111111110000000000",
      "11111111111000000000",
      "11111111111100000000",
      "11111111111111111111"
    ],
    [
      "11111111111111111111",
      "0",
      "0",
      "0",
      "0",
      "0",
      "0",
      "0",
      "0",
      "0",
      "11111111111111111111",
      "11111111111111111111",
      "11111111111111111111",
      "11111111111111111111",
      "11111111111111111111",
      "11111111111111111111",
      "11111111111111111111",
      "11111111111111111111",
      "11111111111111111111",
      "11111111111111111111"
    ]
  ]
}