{
  "top": "closed",
  "left":"shelf",
  "right": "top",
  "bottom": "closed",
  "layers": [
    [
      "11111111111111111111",
      "0",
      "0",
      "0",
      "0",
      "0",
      "0",
      "0",
      "0",
      "0",
      "00000000000000001111",
      "00000000000000011111",
      "00000000000000111111",
      "00000000000001111111",
      "00000000000011111111",
      "00000000000111111111",
      "00000000001111111111",
      "00000000011111111111",
      "00000000111111111111",
      "11111111111111111111"
    ],
    [
      "11111111111111111111",
      "0",
      "0",
      "0",
      "0",
      "0",
      "0",
      "0",
      "0",
      "0",
      "11111111111111111111",
      "11111111111111111111",
      "11111111111111111111",
      "11111111111111111111",
      "11111111111111111111",
      "11111111111111111111",
      "11111111111111111111",
      "11111111111111111111",
      "11111111111111111111",
      "11111111111111111111"
    ]
  ]
}