{
  "top": "open",
  "left": "top",
  "right": "top",
  "bottom": "right",
  "layer": [
    "0",
    "0",
    "0",
    "0",
    "0",
    "0",
    "0",
    "0",
    "0",
    "0",
    "11111110000000000001",
    "11111110000000000001",
    "11111111000000000011",
    "11111111000000000011",
    "11111111100000000111",
    "11111111100000000111",
    "11111111110000001111",
    "11111111110000001111",
    "11111111110000001111",
    "11111111110000001111"
  ]
}