{
  "left": "top",
  "right": "top",
  "bottom": "left",
  "layer": [
    "11111111111111111111",
    "0",
    "0",
    "0",
    "0",
    "0",
    "0",
    "0",
    "0",
    "0",
    "10000000000001111111",
    "10000000000001111111",
    "11000000000011111111",
    "11000000000011111111",
    "11100000000111111111",
    "11100000000111111111",
    "11110000001111111111",
    "11110000001111111111",
    "11110000001111111111",
    "11110000001111111111"
  ]
}