{
  "top": "open",
  "left": "open",
  "right": "open",
  "bottom": "closed",
  "layers": [
    [
      "0",
      "0",
      "0",
      "0",
      "0",
      "0",
      "0",
      "0",
      "0",
      "0",
      "00000000011000000000",
      "00000000111100000000",
      "00000001111110000000",
      "00000011111111000000",
      "00000111111111100000",
      "00001111111111110000",
      "00011111111111111000",
      "00111111111111111100",
      "01111111111111111110",
      "11111111111111111111"
    ],
    [
      "10000000000000000001",
      "11000000000000000011",
      "11100000000000000111",
      "11110000000000001111",
      "11111000000000011111",
      "11111100000000111111",
      "11111110000001111111",
      "11111111000011111111",
      "11111111100111111111",
      "11111111111111111111",
      "11111111111111111111",
      "11111111111111111111",
      "11111111111111111111",
      "11111111111111111111",
      "11111111111111111111",
      "11111111111111111111",
      "11111111111111111111",
      "11111111111111111111",
      "11111111111111111111",
      "11111111111111111111"
    ]
  ]
}